R 1000 562,5
NO textures/eagle.xpm
SO textures/purplestone.xpm
EA textures/bluestone.xpm
WE textures/wood.xpm
S textures/sprite_1.xpm
F 184,113,39
C 33,255,227
1111111111111111111111111111
10000000001100001000000000001
101100000111000100000000001001
10010000000000010000000100011
101100001110000000000010001111111
100000001  1100110000011100000001
11101111111110111000000100011111
11110111111110111010100100011
11000000110101011100000010001
10000000000000001100000010001
10000000000000001101010010001
11000000110101000000000000001
11110111110101000000000000001
10000000001100000100000010001
10000000000000001010000101001
1000000001000010001010001001
10000000001101000000000000001
100000000001000000010100000N1
11111111111111111111111111111
1111111111111111111111111111
