R 848 480
NO textures/eagle.xpm
SO textures/.xpm
EA textures/wall_.xpm
WE textures/wall_4.xpm
S textures/sprite_1.xpm
F 184,113,39
C 33,255,227
11111111111111111111111111111
11000000110101000000000000001
11110111110101000000000000001
10000000001100000100000010001
10000000000000001010000111001
10000000010001100011100001111
10000000001101000000000000001
10000000000100000001010000011
11111111111111111111111111111
