R 1000 562,5
NO textures/eagle.xpm
SO textures/purplestone.xpm
EA textures/bluestone.xpm
WE textures/wood.xpm
S textures/barrel.xpm
F 184,113,39
C 78,99,199
1111111111111111111111111111
10000000001100001000000000001
101100000111000100000000001001
10010000000000010000000100011
101100001110000000000010001111111
1000000011100110000011100000001
11101111111110111000000100011111
11110111111110111010100100011
11000000110101011100000010001
10000000000000001100000010001
10000000000000001101010010001
11000000110101000000000000001
11110111110101000000000000001
10000000001100000100000010001
10000000000000001010000101001
1000000001000010001010001001
1000000000110100000000000S001
10000000000100000001010000001111111111111111111111111
100000000001000000111101110000001010000000110010000111111
111111111111100111111111111000001000000000000000000000011
11111111111110011111111111100000000000011111111000000001111111111111111111111111111111111111111111111111111111111111111
111111111111100111111111111000000000000000000000000000000000000000000000000000000000000020000000000000000000000000000011
11111111111111111111111111111111111111111111111111111111111111111111111111111111111111111111111111111111111111111111111
